11111111111111111111111111
10000011000110001000011101
10000010000110001100011001
11000100000000000000000101
10001000010000000000000001
10010000011010011010000111
10000000100101010010110001
10010000000001101000000001
10001000110001100011010001
10001001001000100100101011
10000000010000001000010001
10000011001100110000110001
10010010000010110000100001
10001001001100100000010001
10001001010010021001001011
10000001001100000110000001
10001000110001100011010001
10001001001000100100101011
10000000010000001000010001
10000011001100110000110001
10010010000010110000100001
10010010011001000000100011
10001001010010001001001011
10000001001100000110000001
10001000110001100011010001
10001001001000100100101011
10000000010000001000010001
10000011001100110000110001
10010010000010110000100001
10001001001100100000010001
10001001010010001001001011
10000001001100000110000001
11111111111111111111111111
