111111111111
100000011101
100000100001
110020000101
100010100101
100100000111
111111111111
