111111111111
100000011101
100000100001
110001000101
100010000101
100100000111
100000010001
100100000001
100010010021
100010101011
100000010001
100000110001
100100100001
100010010001
100010010111
100000010001
111111111111
